size
5
grid
1 0 1 1 1
1 1 0 1 1
0 1 1 1 0
1 1 0 1 1
1 1 1 0 1