size
5
grid
S 1 1 1 1
1 1 G 1 1
1 1 1 1 1
1 1 G 1 1
1 1 1 1 T
