size
5
grid
1 1 1 1 1
1 1 1 1 1
1 1 4 1 1
1 1 1 4 1
1 4 1 1 1
